6	6	6	3	3	3	3	3	3	3	3	3	3	6	6   0
6	6	6	6	6	6	3	3	3	3	6	5	6	6	6   0
6	6	6	4	4	6	3	6	3	3	5	5	6	3	3   0
6	6	4	4	4	4	3	6	3	3	5	5	3	3	3   0
6	6	4	4	4	4	3	6	6	3	3	5	3	3	3   0
6	6	6	4	4	3	3	3	3	3	3	5	3	5	5   0
6	6	6	2	2	2	3	3	3	3	3	5	5	5	4   0
6	6	6	3	2	6	6	3	3	5	5	5	5	4	4   0
6	6	6	3	3	6	6	2	3	5	5	5	4	4	4   0
6	6	3	3	3	3	2	2	2	5	5	4	4	4	4   0
6	6	3	3	3	3	3	3	5	5	5	4	4	4	4   0
6	6	3	3	3	3	3	3	5	5	4	4	4	4	4   0
6	6	3	6	6	3	3	5	5	5	4	4	4	4	4   0
6	6	6	6	6	6	3	5	5	5	4	4	4	4	4   0
6	6	6	6	6	6	3	5	5	5	4	4	4	4	4   0
0   0   0   0   0   0   0   0   0   0   0   0   0   0   0   0